0000000001111
0000000001111
0000000000011
0200111000011
0001111100000
0001111110020
0000111100000
1000011100000
1110000000000
1110020000000
1111000000000
