000000110000
000001110000
000001110000
000002010000
000000000000
002000102000
111000110000
111000110000
000000110000
000000000000